##############################
-+######+----+####   #####+-+#
#+-+####|####+--+###   +--+#|#
###|  ##|#######|######|####|#
#+-+####+--+####+--+###+-+##+->
#|#########|#######|#####|####
#|##+--+###|###+---+##   |####
#+--+##|###|###|#########|####
## ####|##++###+-+####+--+####
##  ###|##|######|####|##  ###
### ###+--+###   +----+###  ##
##############################
