##############################
>+######+----+####   #####+-+#
#+-+####|####+--+###   +--+#|#
###|  ##|#######|######|####|#
#+-+####+--+####+--+###+-+##+>
#|#########|#######|#####|####
#|##+--+###|###+---+##   |####
#+--+##|###|###|#########|####
## ####|##++###+-+####+--+####
##  ###|##|######|####|##  ###
### ###+--+###   +----+###  ##
##############################
